111111111111
1C00C1000001
100000000101
10E001000V01
1C100P110001
1CC000110001
1C0V0CCCC0C1
111111111111
