111111111111
1C00C0C00C01
10001000V001
10E00011C001
101000CCCC11
10C00P111001
100C000000C1
111111111111