11111111111111111111
1C00C0000V0CCC00V001
10000VV000C1CC011001
10E00000VCC100011001
1C100P110CC100011CC1
1CC000110CC1CCC0V001
1C0V0CCCCCC1V00000C1
100CCCCCCC00000110C1
1CCCC00000CCC0011VC1
11111111111111111111
