111111111111
1C00CCCCCC01
1000000CCCC1
10E001000CC1
1C100P11CCC1
1CC000110CC1
1C000CCCC0C1
111111111111
