111111111111
1C00C0000V01
10000VV000C1
10E00000VCC1
1C100P110CC1
1CC000110CC1
1C0V0CCCCCC1
111111111111
