111111111111111111111111111111
100000C000000000000100000000C1
10V0C000P00111111CCCCCCCCC0111
1E00000CC001111111CC000000CCC1
11111CCCC111CCCC11111100000001
111110000110000000000C00000001
100000C000010000000000C1111111
1000C000E00CCCCCCC00000C000001
1C0000000001111000VVCCVV000001
1111100001111CCCC0001111100001
111110000111000CCCC11111100CC1
100000C0000CCCCCCCCCCCCCCCC111
1000V000C0010CCC11100000000001
1CCCC000000100000000CCC111CCC1
111111111111111111111111111111